0000000000
0233000330
0003000300
0003333300
0003000000
0003333300
0000003000
0333333000
0000003300
0000000100